000000000010101
010101000100000
000000000010101
010101000100000
000000000010101
010101000000000
101010001010101
000000000101010
101010000000000
000001000101010
101010000000000
000001000101010
101010000000000