a22224003412101
013131300122000	
002224033413131	
313131300122222	
222224003413131	
212121330022222	
141414003414141	
222220300121212	
131314033422222	
222221300131313	
101314003422220	
002221330131310	
1012140034222b0